#######
#.....#
#.###.#
#..X#.#
#####A#
#@....#
#######