############
#..........#
#..........#
#..........#
#..X.......#
#..........#
#..........#
#..........#
#..........#
#..........#
#..........#
############